00 00 00 00 00 00 00 00 00 00 00 00
00 00 00 01 02 03 00 00 01 02 03 00
00 00 00 00 00 00 00 00 00 00 00 00
00 00 00 01 02 03 00 00 01 02 03 00
00 00 00 00 00 00 00 00 00 00 00 00
00 00 00 01 02 03 00 00 01 02 03 00
00 00 00 00 00 00 00 00 00 00 00 00
00 00 00 01 02 03 00 00 01 02 03 00
00 00 00 00 00 00 00 00 00 00 00 00
00 00 00 01 02 03 00 00 01 02 03 00
00 00 00 00 00 00 00 00 00 00 00 00
00 00 00 00 00 00 00 00 00 00 00 00